#############@@@@@@@@@@@##
@@@@@#####@@@@###@@@@@@@@#
######@@@@@@@@@@######&###
@@@@########@@@#@@@@@@@@@#
#####@@@@#########@@@@####
#%@@@@@@@@@@@@#@@@@@######
@@@@@@@@@@###########@@@@@