########@@
@@@#@@#@@&
@###@#####
@@@###@@##
%####@@@@@
#@@@###@@@
@@@@@@####